  NO  ./textures_xpm/wall2.xpm

SO  ./textures_xpm/wall6.xpm

WE  ./textures_xpm/wall5.xpm

EA   ./textures_xpm/wall4.xpm

C 155,100,160
F 111,111,111

                                         11111
                                        11000111111111
11111111111111111                       11000000000001
100000000000000011111111111111111111111111000000000001
101000001000001000000000000000000000000000000000000001
100000000000000011111111111111111111111111111111111111
10001000100010001
10000000000000001
10101010N01010101
10000000000000001
10001000100100001
10000000000000001
10100000100001001
10000000000000001
11111011111111111
    101
11111011111111111
10000000000000001
10100000100000101
10000000000000001
10001000100010001
10000000000000001
10101010001010101
10000000000000001
10001000100100001
10000000000000001
10100000100001001
10000000000000001
11111111111111111
 

