
C 155,100,160
F 111,111,111
  WE  ./textures_xpm/wall6.xpm

SO  ./textures_xpm/wall7.xpm

NO  ./textures_xpm/wall3.xpm

EA   ./textures_xpm/wall8.xpm
                                         11111
                                        11010111111111
11111111111111111                       11000000000001
10000000S000000011111111111111111111111111010010010011
101000001000001000000000000000000000000000000000000001
100000000000000011111111111111111001111111111111011111
10001000100010001               1001           101
10000000000000001               1001           101111111111111111
10101010001010101               1001           100000000000000001
10000000000000001           111110011111       111111111111111101
10001000100100001           100000000001                      101
10000000000000001           100000000001                      101
10100000100001001111111111111000100100011111111111111111111111101
1000000000000000000000000000000000000000000000000000000000000001
11111011111111111111111111111000100100011111111111111111111111101
    101                     100000000001                      101 
11111011111111111           100000000001                      101
10000000000000001           111110011111                      101
10100000100000101               1001                          101
10000000000000001111111111111111100111111111111111111111111111101
10001000100010000000000000000000000000000000000000000000000000001
10000000000000001111111111111111111111111111111111111111111111111
10101010001010101
10000000000000001
10001000100100001
10000000000000001
10100000100001001
10000000000000001
11111111111111111

